1111111111111111111111
1P0C000000000000001011
1000100100001001001011
1000C00000000000001011
1C0E100000000000101011
1000C00000000000011011
1000C00000000000000111
1000C00000000000000011
1000C00000000000000011
1000C00000000000000011
1000C00000000000000011
1000C00000000000000011
1000C00000000000000011
1000C00000000010000011
1000C00000000100000011
100000000000100000C011
100000000000100000C011
100000000000100000C011
1111111111111111111111