1111111
1P00E11
11111C1
1111111