1111111111111
1000000000001
1000000000001
1P0000E0000C1
1111111111111