111111
1P0C01
1000C1
1C0E11
111111