11111111111111111111111111111
1P0C0000000000000010111111111
10001001000010010010110000001
1000C000000000000010110000011
1C0E1000000000001010110000011
1000C000000000000110110000011
1000C000000000000001110000011
1000C000000000000000110000011
100000000000100000C0110000011
100000000000100000C0110000011
100000000000100000C0110000011
100000000000100000C0110000011
100000000000100000C0110000011
100000000000100000C0110000011
100000000000100000C0110000011
100000000000100000C0110000011
100000000000100000C0110000011
100000000000100000C0110000011
100000000000100000C0110000011
100000000000100000C0110000011
100000000000100000C0110000011
100000000000100000C0110000011
100000000000100000C0110000011
100000000000100000C0110000011
100000000000100000C0110000011
10000000000C000000C0000000011
11111111111111111111111111111
