1111111
1PE0001
1111101
10E0001
1011111
10000C1
1111111