1111111111111
1000000000001
10000000000C1
1111111111111
1P0000E000001
1111111111111










22l