1111111111111
10000000000
10000000000C1
1111100011111
1P0000E000001
1111111111111