111111
1P0E01
100001
111111
100C01
111111