1111111
1PE0001
1111101
1000001
1011111
1000001
1111111