1111111
1PE0001
1111101
10G0001
1011111
10000C1
1111111